[
    ["T", "H", "H", "H", "H", "H", "H", "T"],
    ["R", "H", "H", "H", "H", "H", "H", "H"],
    ["R", "H", "H", "H", "H", "H", "H", "H"],
    ["H", "H", "H", "T", "H", "H", "H", "H"],
    ["H", "H", "H", "H", "H", "H", "H", "H"],
    ["H", "H", "H", "H", "H", "H", "H", "H"],
    ["H", "H", "H", "H", "H", "H", "H", "H"],
    ["T", "H", "H", "H", "H", "H", "H", "T"]
  ]
  